##############################
#0    #   #     #            #
#####   # = ###   ##########=#
#k# ######### #####    #     #
# #     #   #   ### #### #####
# # ### # ### # #   #k       #
#     #   #   # # ####### ####
##### # ### ###   ##         #
#   # # #   ######## ### #####
# #   # ###   #   #    ### = #
# # #k#     # # # ####=#   # #
# # ### #####   # #    # ### #
#b#     #     # #   ##k#0#   #
##########################e###

