##############################
#0    #   #     #            #
#####   # = ###   ##########=#
#k# ######### #####    #     #
# #     #   #   ### #### #####
# # ### # ### # #   #k       #
#     #   #   # # ####### ####
##### # ### ###   ##         #
#   # # #   ######## ### #####
#=#   # ###   #   #    ### = #
# # #k#     # # # ####=#   # #
b # ### #####   # #    # ### #
#k#     #     # #   ##k#0#   #
##########################e###

