########
#b   k #
######=#
e 0#0  #
########
